  #####
  #  .###
 ## #$  ###
 # $. #$  #
##@#..  # #
# $  #  $ #
# #  ..# ##
#  $# .$ #
###  *# ##
  ###   #
    #####