#######
#  @  #
###*###
# * . #
# $ * #
#     #
#######