########
#   .  ##
# ##.#  #
#  $    #
## $.*###
 # #.@  #
 # $ ## #
 # $#   #
 ##   ###
  #####