###############
#            .#
#  ########## #
#         $ # #
#          @# #
#           # #
#           # #
#             #
#             #
###############