#######
#   $.#
#     #
#. $ @#
#######