#########
#    .  #
#  $    #
#    $  #
#.   @  #
#       #
#########