        ####
#########  #
#@$ $ $  ..#
# $ $ $#. .#
#      #..##
###########