    #####
    #   #
#####   #####
#     $     #
#  #$# #$#  #
## #..*..# ##
 #$$..*..$$#
 #  .* *.  #
 # #$#*#$# #
 #    $    #
 ###  @  ###
   #######